1111111111111
1P0000100001
100000100001
1111101111C1
1000000000C1
10000000E001
1111111111111