111111111111111
1P0001100000001
100001100C00001
100000000000001
100C00000000111
111000000000001
100000000000001
100000111110001
100000100000001
100C00100000001
111100100000001
100000000000001
1000000000E0001
111111111111111
100001100000001
100001100C00001
100000000000001
100C00000000111
111000000000001
100000000000001
100000111110001
100000100000001
100C00100000001
111100100000001
100000000000001
100000000000001
111111111111111
