11111111111111111111
1P000111000000000001
1000011100C000000001
1000000000000111111
1000C00000000100001
1111100000000100001
1000000000000000001
1000000000000000001
1000000111111110001
1000000100000000001
1000000100000C00001
1111110100000000001
1000000100000000001
1000C00111111110001
1000000000000000001
1000000000000000001
1000000000000000001
10000000000000000E1
11111111111111111111
