1111111111
1P00011C01
1000011001
10000E0001
1111111111
