1111111111
1P0X0C0001
10000E0001
1111111111
