1111111111111111111111111111
1P00001111111111100000000001
1000001000000000100000C00001
1000001000C000001000000000011
1000001000000000000000000011
1000001111100111111111100011
1000000000100100000001000001
1000111000100100C00001000001
1000100000000100000001111001
1000100111111111111000000001
1000100100000000001000111101
1000100100000C00001000100001
1000000100000000000000100001
1111000111111111111000100001
1000000000000000000000100001
1000111111111000111111100001
10001000000010001000000C0001
10001000000010001000000000E1
1111111111111111111111111111
