1111111111
1P0000E001
1111111111
