1111111111
10000C0001
10000E0001
1111111111
