1111111111
1P0C0E0001
111111
1111111111
