111111111
100000001
1P0C0E001
111111011
