1111111111
1111111111
1111111111
111P111111
1111111111
