1111111111111
1P00001000001
1000001000001
1111101111C01
1000000000C01
10000000E0001
1111111111111
