1111111111
1P000C0001
100P0E0001
1111111111
